flight_id,departure_airport,arrival_airport,aircraft_code,tickets_amount,revenue,economy_class,comfort_class,business_class
136119,AAQ,SVO,733,113,1653000.00,102,0,11
136120,AAQ,SVO,733,109,1605400.00,98,0,11
136122,AAQ,SVO,733,97,1431000.00,87,0,10
136130,AAQ,SVO,733,107,1556600.00,97,0,10
136131,AAQ,SVO,733,124,1812800.00,112,0,12
136132,AAQ,SVO,733,116,1714000.00,104,0,12
136135,AAQ,SVO,733,115,1678600.00,104,0,11
136146,AAQ,SVO,733,109,1604200.00,98,0,11
136159,AAQ,SVO,733,115,1700600.00,103,0,12
136164,AAQ,SVO,733,120,1738400.00,109,0,11
136165,AAQ,SVO,733,110,1567600.00,101,0,9
136172,AAQ,SVO,733,110,1617600.00,99,0,11
136178,AAQ,SVO,733,99,1434600.00,90,0,9
136181,AAQ,SVO,733,118,1689600.00,108,0,10
136185,AAQ,SVO,733,104,1520000.00,94,0,10
136202,AAQ,SVO,733,100,1495600.00,89,0,11
136204,AAQ,SVO,733,107,1457800.00,101,0,6
136209,AAQ,SVO,733,112,1615200.00,102,0,10
136215,AAQ,SVO,733,114,1664000.00,103,0,11
136226,AAQ,SVO,733,130,1886000.00,118,0,12
136249,AAQ,SVO,733,123,1800600.00,111,0,12
136250,AAQ,SVO,733,99,1407800.00,91,0,8
136264,AAQ,SVO,733,116,1690800.00,105,0,11
136266,AAQ,SVO,733,108,1566400.00,98,0,10
136268,AAQ,SVO,733,115,1676200.00,104,0,11
136269,AAQ,SVO,733,109,1605400.00,98,0,11
136270,AAQ,SVO,733,111,1628600.00,100,0,11
136275,AAQ,SVO,733,125,1825000.00,113,0,12
136282,AAQ,SVO,733,106,1518800.00,97,0,9
136284,AAQ,SVO,733,117,1677400.00,107,0,10
136293,AAQ,SVO,733,114,1689600.00,102,0,12
136310,AAQ,SVO,733,117,1654200.00,108,0,9
136316,AAQ,SVO,733,130,1886000.00,118,0,12
136320,AAQ,SVO,733,106,1544400.00,96,0,10
136322,AAQ,SVO,733,108,1567600.00,98,0,10
136345,AAQ,SVO,733,108,1517600.00,100,0,8
136348,AAQ,SVO,733,120,1762800.00,108,0,12
136351,AAQ,SVO,733,105,1555400.00,94,0,11
136360,AAQ,SVO,733,97,1455400.00,86,0,11
136366,AAQ,SVO,733,103,1527400.00,92,0,11
136383,AAQ,SVO,733,106,1493200.00,98,0,8
136387,AAQ,SVO,733,121,1775000.00,109,0,12
136389,AAQ,SVO,733,129,1873800.00,117,0,12
136403,AAQ,SVO,733,129,1873800.00,117,0,12
136411,AAQ,SVO,733,110,1590800.00,100,0,10
136420,AAQ,SVO,733,104,1542000.00,93,0,11
136423,AAQ,SVO,733,129,1849400.00,118,0,11
136428,AAQ,SVO,733,115,1678600.00,104,0,11
136436,AAQ,SVO,733,124,1811600.00,112,0,12
136439,AAQ,SVO,733,117,1701800.00,106,0,11
136441,AAQ,SVO,733,128,1837200.00,117,0,11
136452,AAQ,SVO,733,109,1603000.00,98,0,11
136458,AAQ,SVO,733,110,1568800.00,101,0,9
136463,AAQ,SVO,733,122,1788400.00,110,0,12
136464,AAQ,SVO,733,100,1398000.00,93,0,7
136471,AAQ,SVO,733,120,1762800.00,108,0,12
136479,AAQ,SVO,733,122,1738400.00,112,0,10
136485,AAQ,SVO,733,106,1520000.00,97,0,9
136486,AAQ,SVO,733,107,1505400.00,99,0,8
136511,AAQ,NOZ,733,,,,,
136513,AAQ,NOZ,733,,,,,
136514,AAQ,NOZ,733,,,,,
136523,AAQ,NOZ,733,,,,,
136540,AAQ,NOZ,733,,,,,
136544,AAQ,NOZ,733,,,,,
136546,AAQ,NOZ,733,,,,,
136560,AAQ,NOZ,733,,,,,
136567,AAQ,NOZ,733,,,,,
136571,AAQ,EGO,SU9,95,752700.00,83,0,12
136586,AAQ,EGO,SU9,96,759000.00,84,0,12
136600,AAQ,EGO,SU9,97,765300.00,85,0,12
136605,AAQ,EGO,SU9,97,765300.00,85,0,12
136609,AAQ,EGO,SU9,81,639300.00,71,0,10
136612,AAQ,EGO,SU9,94,746400.00,82,0,12
136620,AAQ,EGO,SU9,79,613500.00,70,0,9
136630,AAQ,EGO,SU9,94,746400.00,82,0,12
136632,AAQ,EGO,SU9,91,714300.00,80,0,11
136642,AAQ,EGO,SU9,64,531000.00,54,0,10
136645,AAQ,EGO,SU9,82,633000.00,73,0,9
136649,AAQ,EGO,SU9,96,759000.00,84,0,12
136654,AAQ,EGO,SU9,96,759000.00,84,0,12
136660,AAQ,EGO,SU9,87,677100.00,77,0,10
136661,AAQ,EGO,SU9,96,759000.00,84,0,12
136666,AAQ,EGO,SU9,87,664500.00,78,0,9
136669,AAQ,EGO,SU9,95,752700.00,83,0,12
136672,AAQ,EGO,SU9,96,759000.00,84,0,12
136678,AAQ,EGO,SU9,80,631200.00,70,0,10
136706,AAQ,EGO,SU9,95,740100.00,84,0,11
136709,AAQ,EGO,SU9,87,689700.00,76,0,11
136720,AAQ,EGO,SU9,95,752700.00,83,0,12
136729,AAQ,EGO,SU9,88,695400.00,77,0,11
136733,AAQ,EGO,SU9,94,746400.00,82,0,12
136754,AAQ,EGO,SU9,90,721200.00,78,0,12
136755,AAQ,EGO,SU9,97,765300.00,85,0,12
136757,AAQ,EGO,SU9,97,765300.00,85,0,12
136758,AAQ,EGO,SU9,97,765300.00,85,0,12
136767,AAQ,EGO,SU9,83,651300.00,73,0,10
136769,AAQ,EGO,SU9,88,696000.00,77,0,11
136778,AAQ,EGO,SU9,96,759000.00,84,0,12
136780,AAQ,EGO,SU9,89,714900.00,77,0,12
136781,AAQ,EGO,SU9,97,765300.00,85,0,12
136802,AAQ,EGO,SU9,96,746400.00,85,0,11
136807,AAQ,EGO,SU9,68,531000.00,60,0,8
136815,AAQ,EGO,SU9,97,765300.00,85,0,12
136819,AAQ,EGO,SU9,96,759000.00,84,0,12
136823,AAQ,EGO,SU9,78,620400.00,68,0,10
136827,AAQ,EGO,SU9,97,765300.00,85,0,12
136838,AAQ,EGO,SU9,86,670200.00,76,0,10
136841,AAQ,EGO,SU9,97,765300.00,85,0,12
136844,AAQ,EGO,SU9,79,575100.00,73,0,6
136855,AAQ,EGO,SU9,87,702300.00,75,0,12
136857,AAQ,EGO,SU9,97,765300.00,85,0,12
136861,AAQ,EGO,SU9,87,689100.00,76,0,11
136869,AAQ,EGO,SU9,97,765300.00,85,0,12
136871,AAQ,EGO,SU9,97,765300.00,85,0,12
136875,AAQ,EGO,SU9,97,765300.00,85,0,12
136887,AAQ,EGO,SU9,78,595200.00,70,0,8
136888,AAQ,EGO,SU9,79,626100.00,69,0,10
136900,AAQ,EGO,SU9,97,765300.00,85,0,12
136907,AAQ,EGO,SU9,96,759000.00,84,0,12
136922,AAQ,EGO,SU9,76,607800.00,66,0,10
136927,AAQ,EGO,SU9,97,765300.00,85,0,12
136936,AAQ,EGO,SU9,82,632400.00,73,0,9
136937,AAQ,EGO,SU9,81,626100.00,72,0,9
136951,AAQ,EGO,SU9,90,720600.00,78,0,12
136953,AAQ,EGO,SU9,97,765300.00,85,0,12
136956,AAQ,EGO,SU9,96,746400.00,85,0,11
